NO ./textures/grass.xpm
SO ./textures/purplestone.xpm
WE ./textures/redbrick.xpm
EA ./textures/wood.xpm
PO ./textures/door.xpm
WP ./textures/hache.xpm

F 80,80,100
C 135,206,235

11111111111111111111
1N0000000000000P0001
10000000000000010001
10000000000000010001
10000000000000000001
11111111111111111111