NO ./textures/grass.xpm
SO ./textures/purplestone.xpm
WE ./textures/redbrick.xpm
EA ./textures/wood.xpm
F 220,100,100
C 135,206,235

1111111111
1001000001
100E000001
1001000001
1111111111