NO ./textures/grass.xpm
SO ./textures/purplestone.xpm
WE ./textures/redbrick.xpm
EA ./textures/wood.xpm
F 80,80,100
C 135,206,235

111111111111111111111111111111111111111111111111111111111111111111
100000000000000000000000000000000000000000000000000000000000000001
100000000000000000000000000000000000000000000000000000000000000001
100000000000000000000000000000000000000000000000000000000000000001
1000N0000000000000000000000000000000000000000000000000000000000001
100000000000000000000000000000000000000000000000000000000000000001
100000000000000000000000000000000000000000000000000000000000000001
10000000000000000000000000000000000000000000000000000000000000C001
10000000000000000000000000000000000000000000000000000000000000C001
111111111111111111111111111111111111111111110111111111111111111111
100000000000000000000000000000000000000000010000000000000000000001
100000000000000000000000000000000000000000010000000000000000000001
100000000000000000000000000000000000000000010000000000000000000001
100000000000000000000000000000000000000000010000000000000000000001
1000000000000000000000000000000000000000000B0000000000000000000001
100000000000000000000000000000000000000000010000000000000000000001
100000000000000000000000000000000000000000010000000000000000000001
100000000000000000000000000000000000000000010000000000000000000001
100000000000000000000000000000000000000000C10000000000000000000001
100000000000000000000000000000000000000000C10000000000000000000001
111111111111111111111111111111111111111111111111111110111111111111
100000000000000000000000000000000000000000000000000010000000000001
100000000000000000000000000000000000000000000000000010000000000001
100000000000000000000000000000000000000000000000000010000000000001
100000000000000000000000000000000000000000000000000010000000000001
10000000000000000000000000000000000000000000000000000B000000000001
100000000000000000000000000000000000000000000000000010000000000001
100000000000000000000000000000000000000000000000000010000000000001
100000000000000000000000000000000000000000000000000010000000000001
100000000000000000000000000000000000000000000000000C10000000000001
100000000000000000000000000000000000000000000000000C10000000000001
111111111111111111111111111111111111111111111111111111111111011111
100000000000000000000000000000000000000000000000000000000000010001
100000000000000000000000000000000000000000000000000000000000010001
100000000000000000000000000000000000000000000000000000000000010001
1000000000000000000000000000000000000000000000000000000000000B0001
100000000000000000000000000000000000000000000000000000000000010001
100000000000000000000000000000000000000000000000000000000000010001
100000000000000000000000000000000000000000000000000000000000010001
100000000000000000000000000000000000000000000000000000000000010001
111111111111111111111111111111111111111111111111111111111111111111