NO ./textures/north.xpm
SO ./textures/south.xpm

F 220,100,0
C 100,100,255

111111
1000N1
100001
111111
