NO ./textures/ice_wall.xpm
SO ./textures/ice_wall.xpm
WE ./textures/ice_wall.xpm
EA ./textures/ice_wall.xpm
DR ./textures/door.xpm
MT0 ./textures/animation_pixel_frame_1.xpm
MT1 ./textures/animation_pixel_frame_2.xpm
MT2 ./textures/animation_pixel_frame_3.xpm
MT3 ./textures/animation_pixel_frame_4.xpm
WP0 ./textures/weapon_frame0.xpm
WP1 ./textures/weapon_frame1.xpm
WP2 ./textures/weapon_frame2.xpm
WP3 ./textures/weapon_frame3.xpm

F 180,220,255
C 120,180,220

1111111111
1M000000M1
1000000001
1M0W0000M1
10000D0001
1111111111
